------,------,------,------,------,------,------,------
------,------,------,SWM_A1,------,WLF_A1,------,------
------,------,SWM_A1,ACG_A1,------,WLF_A1,WLF_A1,------
------,------,------,SWM_A1,------,------,------,------
------,------,HOG_A1,------,------,------,------,------
------,------,------,SQR_A1,MSE_A1,------,------,WLF_A1
