SQR_A1,------,MSE_A1,TRE_A1,TRE_A1,TRE_A1,TRE_A1,TRE_A1
------,------,------,TRE_A1,------,------,------,TRE_A1
------,------,------,------,------,------,------,HOG_A1
------,------,------,------,------,------,------,------
------,------,------,TRE_A1,------,------,------,TRE_A1
------,------,MSE_A1,TRE_A1,TRE_A1,------,------,ACG_A1
