------,TRE_A1,------,------,------,------,------,TRE_A1
------,------,------,TRE_A1,TRE_A1,TRE_A1,------,TRE_A1
------,TRE_A1,TRE_A1,------,------,------,------,TRE_A1
------,TRE_A1,TPP_A1,------,TRE_A1,------,------,------
------,------,------,------,TRE_A1,ACG_A1,------,------
SQR_A1,TRE_A1,TRE_A1,TRE_A1,TRE_A1,TPP_A1,------,BER_A1
