------,------,------,------,------,------,SQR_A1,TRE_A1
TRE_A1,TRE_A1,TRE_A1,------,------,TRE_A1,TRE_A1,TRE_A1
WLF_A1,TRE_A1,------,------,------,------,------,TRE_A1
------,TRE_A1,TRE_A1,ACG_A1,------,------,------,TRE_A1
------,------,------,------,------,------,BER_A1,TRE_A1
------,------,------,------,------,------,TRE_A1,TRE_A1
