TRE_A1,------,------,------,------,------,TRE_A1,TRE_A1
TRE_A1,------,SWM_A1,------,------,MSE_A1,TRE_A1,TRE_A1
TRE_A1,------,------,------,------,------,------,------
TRE_A1,------,------,------,------,------,TRE_A1,------
TRE_A1,------,------,------,------,------,TRE_A1,------
TRE_A1,TRE_A1,------,SQR_A1,------,TRE_A1,TRE_A1,ACG_A1
